0 0 0 0 0 0 0 0 0 0 0 0 0 0 0 0 0 0 0 0 0 0 0 0 0
0 9 11 9 11 9 11 9 11 9 9 0 0 0 25 25 25 24 24 24 24 24 24 24 0
0 10 10 10 10 10 10 10 10 10 9 0 0 0 25 25 24 24 28 28 24 28 28 24 0
0 9 9 10 9 1 2 3 9 10 9 0 0 0 25 24 24 27 27 23 24 27 23 24 0
0 10 10 10 9 8 0 4 9 10 10 12 13 14 24 24 27 27 27 23 25 27 23 24 0
0 9 9 10 9 7 6 5 9 9 9 0 0 0 23 24 24 24 24 25 25 25 24 24 0
0 10 10 10 10 10 10 10 10 10 10 0 0 0 23 23 24 23 24 15 16 17 24 25 0
0 9 9 10 9 9 9 9 10 11 9 0 0 0 23 24 24 23 24 22 0 18 24 25 0
0 10 10 10 9 10 10 9 10 10 10 12 0 14 23 24 26 23 24 22 0 18 24 26 0
0 9 9 10 9 10 9 9 10 11 9 0 0 0 24 24 26 25 24 21 20 19 24 26 0
0 10 10 10 9 10 10 10 10 10 10 0 0 0 24 26 26 25 24 28 28 28 24 26 0
0 9 9 10 9 9 9 9 9 9 9 0 0 0 24 24 24 24 24 24 24 24 24 25 0
0 0 0 10 0 0 0 0 0 9 0 0 0 0 0 0 0 0 0 0 0 0 0 0 0 0
0 10 10 10 27 27 27 27 10 10 10 0 0 0 23 23 25 25 24 24 24 24 28 28 0
0 10 27 10 10 10 10 10 10 23 10 0 0 0 23 23 25 25 24 26 26 24 27 23 0
0 10 27 27 24 25 25 25 25 23 10 12 13 14 24 24 24 24 24 26 26 24 27 23 0
0 10 27 27 24 24 24 26 25 23 24 0 0 0 23 23 26 26 23 26 26 24 25 25 0
0 10 23 23 23 23 24 26 25 23 24 0 0 0 23 23 26 26 23 26 26 24 25 25 0
0 10 24 24 24 24 24 24 24 24 24 0 0 0 24 24 24 24 24 24 10 10 10 10 0
0 10 23 23 23 23 10 26 27 27 27 0 0 0 9 9 26 26 28 28 28 23 23 10 0
0 10 28 28 28 28 10 26 23 23 23 0 0 0 9 9 23 23 23 27 27 9 9 10 0
0 10 26 26 25 25 10 26 10 10 10 12 13 14 10 9 9 9 23 23 23 9 9 10 0
0 10 26 26 25 10 10 10 10 27 27 0 0 0 10 10 10 10 10 10 10 10 10 10 0
0 10 10 10 10 10 28 28 28 28 23 0 0 0 9 9 10 9 9 10 9 10 9 9 0
0 0 0 0 0 0 0 0 0 0 0 0 0 0 0 0 0 0 0 0 0 0 0 0 0